811111111119
500000000006
500000000006
b0000400000b
500000000006
500000000006
72222222222a


